C 153,204,255
F 164,169,20





NO textures/simonkraft/bookshelf.xpm
SO textures/simonkraft/wet_sponge.xpm
WE textures/simonkraft/cobblestone.xpm
EA textures/simonkraft/cyan_concrete.xpm



111111111111111111111
1N0000001000000000001
111111111111111111111




