SO   ./textures/simonkraft/wet_sponge.xpm   
EA   ./textures/simonkraft/cyan_concrete.xpm   
WE   ./textures/simonkraft/cobblestone.xpm   
NO   ./textures/simonkraft/bookshelf.xpm   
F     0,0,20    
C     153,204,255     

111111111111111111111
100000000000000000001
111111111S11111111111
       11111