C 153,204,255
F 164,169,20





N O textures/simonkraft/bookshelf.xpm
S O textures/simonkraft/wet_sponge.xpm
W E textures/simonkraft/cobblestone.xpm
E A textures/simonkraft/cyan_concrete.xpm



111111111111111111111
1N00000000000000 0001
11  111             1




