NO textures/wolfenstein/grey_stone.xpm
SO textures/wolfenstein/purple_stone.xpm
WE textures/wolfenstein/red_brick.xpm
EA textures/wolfenstein/wood.xpm

F 220,100,0
C 225,30,0

        1111111111111111111111111
        1000000000110000000000001
        101100000111XXXXXXXXXXXX1
        1001000000000000000000001
111111111011000001110000000000001
10000000001100000111011111C111111
11110111111111011100000010001
111101111111110111010100100X1
11000000110101011100000010XX1
10000000000000001100000010X01
10000000000000001101010010001
11000001110101011111011110N0111
11110111 1110101 101111010001
11111111 1111111 111111111111
